3023333203
3322332233
0012332100
0001331000
0011111100
0030330300
3110220113
0001001000