0023333200
0232222320
2321221232
2310110132
0231111320
0023333200