0001331000
0000220000
0010000100
0121001210
1112332111
0011221100
0000110000