3333233233
3333323332
2223322322
2222323222
2322223232
1211121211
1111211112
