2333333332
0122332210
0012222100
0001221000
0000110000