0000110000
0001221000
0012332100
0123223210
0012332100
0001221000
0000110000